#####
#@$.#
#####
;
#####
#.  #
#. .#
#$$$#
#   #
##@##
#####
;
######
#    #
# $ $#
# .$.#
#.#  #
###@##
  ### 
;
#####
#   #
#   #
#.$.#
#$@$#
#.$.#
#   #
#   #
#####
;
 ####  
 # .#  
##  ###
#@..$ #
##$   #
 # $ ##
 ##  # 
  #### 
;
  #####
  #.$.#
###. ##
#  $ @#
#  $ ##
###  #
  ####
;
########
#@  #  #
# #.$ $#
# $.# .###
##   #   #
 ###  $. #
   ###  ##
     ####
;
  ###   
 ##.#
## $###
#.$.$ ##
#$.  $.#
# @#####
####
;
#####
#.. ####
#..$@  #
#  #$$ #
#### $ #
   #   #
   #####
;
  ######
  #    ##
 ##$# . #
## @ $  #
# ..#.$ #
## $  ###
 #   ##
 #####
;
